{
  "name": "office_hq_80s_expanded",
  "legend": {
    "#": "wall",
    ".": "floor/carpet",
    " ": "opening/void",
    "=": "desk surface",
    ";": "chair",
    "+": "filing cabinet / storage",
    "*": "plant",
    "~": "glass partition",
    ":": "counter / kitchenette",
    "o": "table node",
    "-": "table edge",
    "@": "equipment (copier/fax/server)"
  },
  "rows": [
    "#########################################################################################",
    "#......................~~~~.............................~~~~............................#",
    "#..====................~~~~....###############..........~~~~..............+..+..........#",
    "#..=;;=........................#.............#...........................+..+...........#",
    "#..====.........###############...+.....+....#....###############.......................#",
    "#...............#.............#..............#....#.............#.......................#",
    "#...............#.............###############.....#.............#..........*............#",
    "#...............#..................................#.............#......................#",
    "###########.....#..................................#.............#.....###########......#",
    "#.........#.....########################....######################.....#.........#......#",
    "#.........#............................................................#.........#......#",
    "#..s..s...#............................................................#...s..s..#......#",
    "#.........#.....###########.......###########.......###########........#..........#.....#",
    "#.........#.....#.........#.......#.........#.......#.........#........#.........#......#",
    "#.........#.....#.===.===.#.......#.===.===.#.......#.===.===.#........#....@....#......#",
    "#.........#.....#.=;=.=;=.#.......#.=;=.=;=.#.......#.=;=.=;=.#........#..+...+..#......#",
    "#.........#.....#.===.===.#.......#.===.===.#.......#.===.===.#........#....@....#......#",
    "#.........#.....#...+.+...#.......#...+.+...#.......#...+.+...#........#.........#......#",
    "#.........#.....###########.......###########.......###########........############.....#",
    "#.......................................................................................#",
    "#############################.................#############################.............#",
    "#...........................#.................#...........................#.............#",
    "#..###############..........#.................#..........###############..#.............#",
    "#..#.............#..........#.................#..........#.............#..#.............#",
    "#..#..===.===....#..........#...o-o-o-o-o.....#..........#....===.===..#..#.............#",
    "#..#..=;=.=;=....#..........#...o-------o.....#..........#....=;=.=;=..#..#.............#",
    "#..#..===.===....#..........#...o-o-o-o-o.....#..........#....===.===..#..#.............#",
    "#..#..+.....+....#..........#.................#..........#....+.....+..#..#.............#",
    "#..#.............#..........#.................#..........#.............#..#.............#",
    "#..######...######..........#######.....#######..........######...######..#.............#",
    "#.......................................................................................#",
    "#....###############....................###############....................############.#",
    "#....#.............#....................#.............#....................#..........#.#",
    "#....#..:::::::::..#....................#..@..+..@....#....................#..@..+..@.#.#",
    "#....#..:.......:..#....................#..+..@..+....#....................#..+..@..+.#.#",
    "#....#..:::::::::..#....................#..@..+..@....#....................#..@..+..@.#.#",
    "#....#.....*.......#....................#.....*.......#....................#....*.....#.#",
    "#....######...######....................######...######....................######...###.#",
    "#.......................................................................................#",
    "#..###########..............###########..............###########..............###########",
    "#..#.........#..............#.........#..............#.........#..............#........##",
    "#..#..+.+.+..#..............#..+.+.+..#..............#..+.+.+..#..............#..+.+...##",
    "#..#..@.@.@..#..............#..@.@.@..#..............#..@.@.@..#..............#..@.@...##",
    "#..#..+.+.+..#..............#..+.+.+..#..............#..+.+.+..#..............#..+.+...##",
    "#..#.........#..............#.........#..............#.........#..............#........##",
    "#..#####...###..............#####...###..............#####...###..............####...####",
    "#.......................................................................................#",
    "#########################################################################################"
  ]
}